"entities";"negative";"positive";"neutral";"neg";"pos";"neu";"total";"Count"
"Getty Images";32;44;24;8;11;6;25;48
"Reuters";45;27;27;10;6;6;22;48
"BBC";40;25;35;8;5;7;20;44
"MPs";26;47;26;5;9;5;19;19
"Twitter";18;53;29;3;9;5;17;35
"BBC News";29;53;18;5;9;3;17;20
"London";50;43;7;7;6;1;14;25
"UK";54;8;38;7;1;5;13;53
"AFP";38;31;31;5;4;4;13;18
"US";45;27;27;5;3;3;11;56
"Facebook";9;64;27;1;7;3;11;20
"EU";60;20;20;6;2;2;10;45
"Europe";25;38;38;2;3;3;8;17
"PA";38;38;25;3;3;2;8;13
"Northern Ireland";86;14;0;6;1;0;7;34
"British";29;29;43;2;2;3;7;18
"China";29;57;14;2;4;1;7;16
"Westminster";43;29;29;3;2;2;7;12
"Washington";0;71;29;0;5;2;7;8
"Queen";14;14;71;1;1;5;7;7
"Britain";50;17;33;3;1;2;6;26
"Donald Trump";50;0;50;3;0;3;6;25
"EPA";33;33;33;2;2;2;6;10
"Instagram";17;67;17;1;4;1;6;8
"Conservative";60;20;20;3;1;1;5;8
"BBC Mundo";20;80;0;1;4;0;5;7
"president";40;60;0;2;3;0;5;5
"France";0;20;80;0;1;4;5;5
"Prime Minister";40;40;20;2;2;1;5;5
"Labour";25;50;25;1;2;1;4;20
"Theresa May";75;25;0;3;1;0;4;16
"Ireland";25;75;0;1;3;0;4;13
"Google";50;0;50;2;0;2;4;12
"Japan";25;25;50;1;1;2;4;12
"Getty Images Image";50;25;25;2;1;1;4;10
"Ghana";25;0;75;1;0;3;4;10
"Canada";50;25;25;2;1;1;4;10
"Tuesday";50;25;25;2;1;1;4;9
"England";50;0;50;2;0;2;4;8
"Islamic State";50;0;50;2;0;2;4;6
"Grenfell";50;25;25;2;1;1;4;5
"European Union";50;25;25;2;1;1;4;5
"professor";25;25;50;1;1;2;4;4
"PM";75;0;25;3;0;1;4;4
"Pakistan";0;0;100;0;0;4;4;4
"German";0;25;75;0;1;3;4;4
"Italy";25;25;50;1;1;2;4;4
"commanders";100;0;0;4;0;0;4;4
"English";0;67;33;0;2;1;3;17
"Parliament";0;67;33;0;2;1;3;14
"Irish";0;33;67;0;1;2;3;10
"House of Fraser";33;67;0;1;2;0;3;9
"Poundworld";100;0;0;3;0;0;3;9
"Scotland";67;33;0;2;1;0;3;7
"Republic of Ireland";33;33;33;1;1;1;3;7
"White House";100;0;0;3;0;0;3;6
"Australia";33;33;33;1;1;1;3;6
"Guatemala";67;33;0;2;1;0;3;6
"Tory";67;33;0;2;1;0;3;5
"Scottish";0;33;67;0;1;2;3;5
"April";100;0;0;3;0;0;3;5
"Mexico";67;0;33;2;0;1;3;5
"New York";33;67;0;1;2;0;3;5
"cabinet";33;0;67;1;0;2;3;4
"estadounidense";67;33;0;2;1;0;3;4
"Texas";33;0;67;1;0;2;3;4
"India";0;33;67;0;1;2;3;4
"a year";33;0;67;1;0;2;3;4
"Jeremy Corbyn";33;33;33;1;1;1;3;4
"House of Commons";100;0;0;3;0;0;3;4
"Russia";0;100;0;0;3;0;3;4
"Brexit Secretary";0;67;33;0;2;1;3;3
"Brexit secretary";0;67;33;0;2;1;3;3
"Irish border";100;0;0;3;0;0;3;3
"Poland";33;0;67;1;0;2;3;3
"Radio 4";0;33;67;0;1;2;3;3
"Spain";0;33;67;0;1;2;3;3
"UK government";33;33;33;1;1;1;3;3
"three years";33;33;33;1;1;1;3;3
"Judge";67;0;33;2;0;1;3;3
"commander";0;0;100;0;0;3;3;3
"presidente";33;0;67;1;0;2;3;3
"singer";0;0;100;0;0;3;3;3
"Germany";33;0;67;1;0;2;3;3
"cleric";33;67;0;1;2;0;3;3
"MP";33;33;33;1;1;1;3;3
"Peter Stringfellow";50;50;0;1;1;0;2;58
"Paul Dacre";0;50;50;0;1;1;2;36
"Taliban";100;0;0;2;0;0;2;26
"David Davis";100;0;0;2;0;0;2;18
"Afghanistan";100;0;0;2;0;0;2;18
"Afghan";100;0;0;2;0;0;2;17
"English Parliament";0;0;100;0;0;2;2;13
"United States";50;0;50;1;0;1;2;13
"YouTube";0;50;50;0;1;1;2;13
"چین";0;0;100;0;0;2;2;12
"Cardiff";0;100;0;0;2;0;2;12
"United Kingdom";0;100;0;0;2;0;2;11
"Supreme Court";50;50;0;1;1;0;2;11
"London Fire Brigade";0;50;50;0;1;1;2;10
"Estados Unidos";0;0;100;0;0;2;2;10
"Labour Party";50;0;50;1;0;1;2;9
"Ashraf Ghani";100;0;0;2;0;0;2;8
"European";50;50;0;1;1;0;2;8
"11 juin 2018";0;0;100;0;0;2;2;8
"Sarah Ewart";50;50;0;1;1;0;2;8
"Grenfell Tower";50;50;0;1;1;0;2;7
"Mike Kenny";0;0;100;0;0;2;2;6
"Jennifer Sutcliffe";50;0;50;1;0;1;2;6
"Swedish";100;0;0;2;0;0;2;6
"10 juin 2018";0;0;100;0;0;2;2;6
"Newsbeat";0;100;0;0;2;0;2;6
"David Cameron";100;0;0;2;0;0;2;5
"UN";100;0;0;2;0;0;2;5
"Deloitte";0;50;50;0;1;1;2;5
"Leo Varadkar";50;50;0;1;1;0;2;5
"12 juin 2018";50;0;50;1;0;1;2;5
"Belfast";0;50;50;0;1;1;2;5
"Liverpool";0;0;100;0;0;2;2;5
"Lord Kerr";100;0;0;2;0;0;2;5
"The Sun";100;0;0;2;0;0;2;4
"NHS";50;50;0;1;1;0;2;4
"Scottish Parliament";100;0;0;2;0;0;2;4
"Iraq";0;50;50;0;1;1;2;4
"Indian";50;0;50;1;0;1;2;4
"Eighth Amendment";0;50;50;0;1;1;2;4
"Brussels";50;50;0;1;1;0;2;4
"Chile";50;50;0;1;1;0;2;4
"Japanese";50;0;50;1;0;1;2;4
"Commons";0;50;50;0;1;1;2;4
"American";50;50;0;1;1;0;2;4
"Afrique";0;0;100;0;0;2;2;4
"Sistema Solar";50;50;0;1;1;0;2;4
"Daily Mail";0;50;50;0;1;1;2;3
"Lawless";50;0;50;1;0;1;2;3
"Liam Fox";100;0;0;2;0;0;2;3
"Nigeria";0;0;100;0;0;2;2;3
"Metro";50;50;0;1;1;0;2;3
"Downing Street";50;0;50;1;0;1;2;3
"Laura Kuenssberg";50;0;50;1;0;1;2;3
"Scottish independence";100;0;0;2;0;0;2;3
"Melbourne";0;50;50;0;1;1;2;3
"Afghan government";50;0;50;1;0;1;2;3
"Singapore";0;100;0;0;2;0;2;3
"Indonesia";50;50;0;1;1;0;2;3
"KIII";50;0;50;1;0;1;2;3
"Catholic";0;100;0;0;2;0;2;3
"Harrods";100;0;0;2;0;0;2;3
"BBC News Mundo";0;0;100;0;0;2;2;3
"dimanche";100;0;0;2;0;0;2;3
