"entities";"negative";"positive";"neutral";"neg";"pos";"neu";"total";"Count"
"Twitter";11;32;57;22;64;113;199;252
"Donald Trump";31;32;36;56;58;65;179;1042
"AFP";23;27;50;26;31;56;113;152
"Getty Images";25;29;46;27;32;51;110;149
"Facebook";12;47;42;12;48;43;103;229
"American";37;35;28;37;35;28;100;227
"United States";41;35;24;40;34;24;98;310
"Thursday";28;35;37;27;33;35;95;141
"White House";38;32;30;30;25;24;79;161
"Breitbart News";18;28;54;14;22;42;78;153
"AP";20;36;45;15;27;34;76;96
"U.S.";39;29;32;29;22;24;75;193
"America";33;39;28;23;27;19;69;126
"Americans";40;28;31;27;19;21;67;162
"Trump";27;24;49;17;15;31;63;152
"Getty";31;33;36;18;19;21;58;59
"Congress";32;36;32;16;18;16;50;81
"Democrats";40;34;26;19;16;12;47;116
"Associated Press";30;35;35;14;16;16;46;73
"Breitbart";22;15;63;10;7;29;46;99
"Barack Obama";29;40;31;13;18;14;45;173
"Washington";29;24;47;11;9;18;38;47
"Prime Minister";25;31;44;9;11;16;36;36
"California";27;24;48;9;8;16;33;81
"Hillary Clinton";36;39;24;12;13;8;33;92
"Attorney General";6;30;64;2;10;21;33;33
"Washington, D.C.";16;56;28;5;18;9;32;51
"Republicans";34;38;28;11;12;9;32;123
"Europe";35;26;39;11;8;12;31;63
"Senate";26;26;48;8;8;15;31;74
"Muslim";27;30;43;8;9;13;30;57
"CNN";23;23;53;7;7;16;30;110
"President Obama";30;13;57;9;4;17;30;255
"Speaker";14;34;52;4;10;15;29;29
"Senator";18;39;43;5;11;12;28;28
"Germany";37;15;48;10;4;13;27;69
"Fox News";52;22;26;14;6;7;27;39
"Chinese";33;44;22;9;12;6;27;74
"FBI";58;35;8;15;9;2;26;54
"Russia";23;27;50;6;7;13;26;68
"China";38;8;54;10;2;14;26;132
"governor";31;27;42;8;7;11;26;26
"Iraq";48;20;32;12;5;8;25;43
"German";33;21;46;8;5;11;24;53
"chief";8;25;67;2;6;16;24;24
"New York Times";17;63;21;4;15;5;24;28
"CEO";21;42;38;5;10;9;24;24
"Vice President";8;63;29;2;15;7;24;24
"Republican";25;50;25;6;12;6;24;45
"European Union";30;30;39;7;7;9;23;32
"Saturday";13;61;26;3;14;6;23;31
"November";39;17;43;9;4;10;23;36
"Russian";52;17;30;12;4;7;23;65
"Chancellor";35;26;39;8;6;9;23;23
"Jerusalem";17;26;57;4;6;13;23;47
"EU";32;36;32;7;8;7;22;91
"April";18;32;50;4;7;11;22;24
"Syria";32;9;59;7;2;13;22;61
"North Korea";36;23;41;8;5;9;22;79
"Dr.";36;27;36;8;6;8;22;22
"09-Jun-18";18;32;50;4;7;11;22;23
"January";38;19;43;8;4;9;21;24
"Mayor";24;14;62;5;3;13;21;21
"Democratic";43;33;24;9;7;5;21;54
"British";24;19;57;5;4;12;21;36
"Mrs.";24;76;0;5;16;0;21;21
"New York";15;45;40;3;9;8;20;26
"Secretary of State";20;35;45;4;7;9;20;20
"Monday";30;20;50;6;4;10;20;24
"Breitbart London";35;5;60;7;1;12;20;32
"December";35;15;50;7;3;10;20;22
"Texas";30;10;60;6;2;12;20;83
"Canada";30;35;35;6;7;7;20;42
"Obama administration";30;40;30;6;8;6;20;27
"Secretary";26;37;37;5;7;7;19;19
"chairman";5;26;68;1;5;13;19;19
"Islamic";47;16;37;9;3;7;19;48
"North Korean";32;58;11;6;11;2;19;36
"Kim Jong-un";37;47;16;7;9;3;19;113
"United Nations";37;26;37;7;5;7;19;69
"president-elect";37;47;16;7;9;3;19;19
"European";28;28;44;5;5;8;18;33
"Washington, DC";50;17;33;9;3;6;18;25
"Israel";33;33;33;6;6;6;18;32
"London";11;28;61;2;5;11;18;54
"attorney";17;33;50;3;6;9;18;18
"Singapore";17;44;39;3;8;7;18;55
"King";12;59;29;2;10;5;17;17
"February";35;6;59;6;1;10;17;17
"Gov.";18;47;35;3;8;6;17;17
"Director";35;35;29;6;6;5;17;17
"Donald J. Trump";41;47;12;7;8;2;17;110
"Sunday";25;31;44;4;5;7;16;24
"God";31;50;19;5;8;3;16;22
"Democrat";31;44;25;5;7;4;16;17
"director";6;50;44;1;8;7;16;16
"ambassador";13;25;63;2;4;10;16;16
"prime minister";50;25;25;8;4;4;16;16
"English";13;53;33;2;8;5;15;23
"Mexico";33;33;33;5;5;5;15;27
"Paul Ryan";27;47;27;4;7;4;15;138
"France";33;27;40;5;4;6;15;27
"Iran";73;0;27;11;0;4;15;60
"Hollywood";13;47;40;2;7;6;15;23
"Ben Kew";0;87;13;0;13;2;15;16
"bkew@breitbart.com";0;100;0;0;15;0;15;15
"a week";43;36;21;6;5;3;14;14
"Capitol Hill";21;36;43;3;5;6;14;15
"Islamic State";29;7;64;4;1;9;14;79
"Iranian";64;14;21;9;2;3;14;39
"Washington Post";7;57;36;1;8;5;14;17
"Bill Clinton";21;43;36;3;6;5;14;49
"Beijing";14;21;64;2;3;9;14;31
"G7";21;71;7;3;10;1;14;22
"D.C.";36;29;36;5;4;5;14;18
"John Binder";0;23;77;0;3;10;13;19
"executive";23;46;31;3;6;4;13;13
"a month";46;23;31;6;3;4;13;14
"Florida";15;31;54;2;4;7;13;19
"Jewish";54;31;15;7;4;2;13;24
"Mike Pompeo";8;38;54;1;5;7;13;21
"Pyongyang";8;23;69;1;3;9;13;26
"senator";23;46;31;3;6;4;13;13
"State Department";31;15;54;4;2;7;13;23
"Google";38;23;38;5;3;5;13;50
"Islam";31;23;46;4;3;6;13;37
"The New York Times";38;31;31;5;4;4;13;33
"presidents";23;54;23;3;7;3;13;13
"US";31;46;23;4;6;3;13;30
"Governor";31;23;46;4;3;6;13;13
"New York City";42;33;25;5;4;3;12;17
"South Korea";33;25;42;4;3;5;12;27
"GOP";25;33;42;3;4;5;12;26
"Reuters";8;25;67;1;3;8;12;15
"Muslims";58;17;25;7;2;3;12;30
"Middle East";42;17;42;5;2;5;12;20
"Mike Pence";33;67;0;4;8;0;12;45
"Foreign Minister";0;33;67;0;4;8;12;12
"French";25;33;42;3;4;5;12;16
"05-Jun-18";33;17;50;4;2;6;12;14
"Aaron Klein";0;75;25;0;9;3;12;52
"October";33;17;50;4;2;6;12;15
"YouTube";33;25;42;4;3;5;12;14
"Obama";25;42;33;3;5;4;12;22
"Britain";33;33;33;4;4;4;12;34
"Pentagon";17;33;50;2;4;6;12;26
"mayor";55;36;9;6;4;1;11;11
"a decade";36;27;36;4;3;4;11;12
"professor";0;27;73;0;3;8;11;11
"Afghanistan";18;9;73;2;1;8;11;16
